page=Page 
content=Welcome to the page 
title=My products
home=Home
products=Products Overview
info=information
contact=contact
IdDelete=Id to delete not found
editProducts=Edit Products
orderDetail=Order Detail
addProduct=Add Product
changeProduct=Change Product
editUser=Edit User
contact=Contact
login=Login
loggedIn=sucessfully logged in.
loggedOut=You sucessfully logged out.
requireLogin=You need to be logged in to use the shopping cart
orderSuccessful=Your order will be processed soon.
checkout=Checkout
register=Register
invalidActivation=Invalid Activation Code
validActivation=Activated sucessfully
invalidFirstname=Invalid Firstname
invalidLastname=Invalid Lastname
invalidAddress=Invalid Address
invalidPlz=Invalid ZIP
invalidCity=Invalid City
invalidEmail=Invalid Email
invalidCEmail=Invalid confirmation Email
invalidPassword=Invalid Password
invalidCPassword=Invalid confirmation Password
registerSuccessful=You have been registred sucessfully. Please activate your account. 
