page=Page
content=Bienvenue sur la page
title=Mes produits
home=Home
products=Aperçu des produits
info=information
contact=contact
IdDelete=Identifiant à supprimer introuvable
editProducts=Modifier les produits
checkAllOrders=vérifier toutes les commandes
orderDetail=Détails de la commande
addProduct=Ajouter un produit
changeProduct=Changer de produit
editUser=Modifier l'utilisateur
contact=Contact
login=S'identifier
logout=Connectez - Out
loggedIn=connecté avec succès.
loggedOut=Vous avez réussi à vous déconnecter.
requireLogin=Vous devez être connecté pour utiliser cette functionalité
orderSuccessful=Votre commande sera traitée bientôt.
checkout=Check-out
register=registre
invalidActivation=Code d'activation invalide
validActivation=Activé avec succès
invalidFirstname=Prénom invalide
invalidLastname=Nom de famille invalide
invalidAddress=Adresse invalide
invalidPlz=ZIP non valide
invalidCity=Ville invalide
invalidEmail=Email invalide
invalidCEmail=Confirmation invalide Email
invalidPassword=Mot de passe incorrect
invalidCPassword=Mot de passe de confirmation invalide
registerSuccessful=Vous avez été enregistré avec succès. Veuillez activer votre compte.
unknownProduct=Produit inconnu
emailExists=L'email existe déjà.
unknownUser=Utilisateur inconnu
invalidActivationHash=Invalid ou déjà utilisé Activation Hash
invalidLogin=Mot de passe ou adresse courriel invalide
userNotActivated=Utilisateur pas encore activé
removeItem=Retirer l'objet
emptyCart=Panier vide
orderInfo=Afficher les informations sur les commandes
title=Titre
quantity=Quantité
price=Prix
customerId=N ° de client
amount=Montant
name=prénom
address=Adresse
city=Ville
plz=ZIP
paymentType=Type de paiement
status=Statut
date=Rendez-vous amoureux
detail=Détail
totalQuantity=Quantité totale
totalPrice=Prix ​​total
customerDetails=Détails du client
customerName=Nom du client
proceedToPayment=Procéder au paiement
enterInformation=S'il vous plaît entrer vos informations
firstname=Prénom
lastname=Nom de famille
addressLine=Ligne d'adresse
email=Email
cemail=Confirmez votre e-mail
pw=Mot de passe
cpw=Confirmez le mot de passe
enterProductInfo=S'il vous plaît entrer les informations pour les produits
code=Code
img=Image
cancel=Annuler
edit=modifier
delete=Effacer
add=Ajouter
welcome=Bienvenue à notre magasin.
pleaseLogin= Veuillez vous connecter pour commander des montres.
thanks=Merci de nous choisir
infoText=Nous vendons des montres - duh!
underConstruction=En construction!
productId=Identifiant du produit
back=Retourner.
products=Des produits
goToCheckout=Aller à la caisse.
