page=Seite
content=Wilkommen auf der Seite
title=Meine Produkte
home=Home
products=Produkte
info=Informationen
contact=Kontakt
IdDelete=ID zum Löschen nicht gefunden
editProducts=Produkte bearbeiten
orderDetail=Bestelldetails
addProduct=Produkt hinzufügen
changeProduct=Produkt ändern
editUser=Benutzer bearbeiten
contact=Kontakt
login=Anmeldung
loggedIn=erfolgreich eingeloggt.
loggedOut=Sie haben sich erfolgreich ausgeloggt.
requireLogin=Sie müssen eingeloggt sein, um den Warenkorb nutzen zu können.
orderSuccessful=Ihre Bestellung wird in Kürze bearbeitet.
checkout=Auschecken
register=Registrieren
invalidActivation=Ungültiger Aktivierungscode
validActivation=Erfolgreich aktiviert
invalidFirstname=Ungültiger Vorname
invalidLastname=Ungültiger Nachname
invalidAddress=Ungültige Adresse
invalidPlz=Ungültige PLZ
invalidCity=Ungültige Stadt
invalidEmail=Ungültige E-Mail
invalidCEmail=Ungültige E-Mail Bestätigung
invalidPassword=Ungültiges Passwort
invalidCPassword=Ungültiges Bestätigungspasswort
registerSuccessful=Sie wurden erfolgreich registriert. Bitte aktiviere deinen Account.
unknownProduct=Unbekanntes Produkt
emailExists=E-Mail existiert bereits.
unknownUser=Unbekannter Benutzer
invalidActivationHash=Ungültiger oder bereits verwendeter Aktivierungshash
invalidLogin=Ungültiges Passwort oder E-Mail
userNotActivated=Benutzer noch nicht aktiviert
removeItem=Gegenstand entfernen
emptyCart=Leerer Warenkorb
orderInfo=Informationen zu den Bestellungen anzeigen
title=Titel
quantity=Menge
price=Preis
customerId=Kundennummer
amount=Menge
name=Name
address=Adresse
city=City
plz=POSTLEITZAHL
paymentType=Zahlungsart
status=Status
date=Datum
detail=Detail
totalQuantity=Gesamtmenge
totalPrice=Gesamtpreis
customerDetails=Kundendetails
customerName=Kundenname
proceedToPayment=Weiter zur Zahlung
enterInformation=Bitte geben Sie Ihre Daten ein
firstName=Vorname
lastname=Nachname
addressLine=Adresszeile
email=Email
cemail=Bestätigungs-E-Mail
pw=Passwort
cpw=Bestätige das Passwort
enterProductInfo=Bitte geben Sie die Informationen für die Produkte ein
code=Code
img=Bild
cancel=Stornieren
edit=Bearbeiten
delete=Löschen
add=Hinzufügen
welcome=Willkommen in unserem Geschäft.
